40
M M M M M M M M M M M M M M M M M M M M M M M M M M M M M M M M M M M M M M M M
M V V V V V V V V V V V V V V V V V V V V V V V V V V V V V V V V V V V V V V M
M V V V V V V V V V V V V V V V V V V V V V V V V V V V V V V V V V V V V V V M
M V V V V V V V V V V V V V V V V V V V V V V V V V V V V V V V V V V V V V V M
M V V V V V V V V V V V V V V V V V V V V V V V V V V V V V V V V V V V V V V M
M V H V V V V V V V V V V V V V V V V V V V V V V V V V V V V V V V V V V V V M
M M M M M M M M M M M M M M M M M M M M M M M M M M M M M V V V V V V V V V V M
M V V V V V V V V V V V V V V V V V V V V V V V V V V V V V V V V V V V V V V M
M V B M V V M V V M V V M V V M V V M V V M V V M V V M V V V V V V V V V V V M
M M M M M M M M M M M M M M M M M M M M M M M M M M M M M M M M M M M M M M M M