40
M M M M M M M M M M M M M M M M M M M M M M M M M M M M M M M M M M M M M M M M
M V V V V V V V V V V V V V V V V V V V V V V V V V V V V V V V V V V V V V V M
M V V V V V V V V V V V V V V V V V V V V V V V V V V V V V V V V V V V V V V M
M V V V V V V V V V V V V V V V V V V V V V V V V V V V V V V V V V V V V V V M
M V V V V V V V V V V V V V V V V V V V V V V V V V V V V V V V V V V V V V V M
M V H V V V V V V V V V V V V V V V V V V V V V V V V V V C V V V V V V V V V M
M M M M M M M M M M M M M M M M M M M M M M M M M M M M M C V V V V V V V V V M
M V V V V V V V V V V V V V V V V V V V V V V V V V V V V C V V V V V V V V V M
M V B V V V V V V V V V V V V V V V V V V V V V V V V V V C V V V V V V V V V M
M M M M M M M M M M M M M M M M M M M M M M M M M M M M M M M M M M M M M M M M